###########################################
#.........................................#
#.........................................#
#                                         #
#                                         #
#                                         #
#                                         #
#                                         #
#                                         #
#                                         #
#                                         #
#                                         #
#                                         #
#                                         #
#                                         #
#                                         #
###########################################